#######################################
#######################################
## #       #       #     #         # ##
## # ##### # ### ##### ### ### ### # ##
##       #   # #     #     # # #   # ##
###### # ##### ##### ### # # # ##### ##
##   # #       #     # # # # #     # ##
## # ####### # # ##### ### # ##### # ##
## #       # # #   #     #     #   # ##
## ####### ### ### # ### ##### # ### ##
##     #   # #   # #   #     # #     ##
## ### ### # ### # ##### # # # ########
##   #   # # #   #   #   # # #   #   ##
######## # # # ##### # ### # ### ### ##
##     # #     #   # #   # #   #     ##
## ### # ##### ### # ### ### ####### ##
## #   #     #     #   # # #       # ##
## # ##### # ### ##### # # ####### # ##
## #     # # # # #     #       # #   ##
## ##### # # # ### ##### ##### # ######
## #   # # #     #     # #   #       ##
## # ### ### ### ##### ### # ##### # ##
## #         #     #       #       # ##
##O####################################
#######################################