#######
#######
## # ##
##   ##
#######
## # ##
##   ##
##O####
#######